TNEROLFLORENT
ITNEROLORENTI
UITNERORENTIU
MUITNERENTIUM
IMUITNENTIUMI
NIMUITNTIUMIN
DNIMUITIUMIND
IDNIMUIUMINDI
GIDNIMUMINDIG
NGIDNIMINDIGN
UNGIDNINDIGNU
MUNGIDNDIGNUM
MMUNGIDIGNUMM
EMMUNGIGNUMME
MEMMUNGNUMMEM
OMEMMUNUMMEMO
ROMEMMUMMEMOR
AROMEMMMEMORA
RAROMEMEMORAR
ERAROMEMORARE